{
    "tiles" : [[0, 0, 0, 0, 0, 0],
               [0, 0, 0, 0, 0, 0],
               [0, 1, 1, 1, 1, 0],
               [0, 1, 1, 1, 1, 0],
               [0, 1, 1, 1, 1, 0],
               [0, 1, 1, 1, 1, 0],
               [0, 0, 0, 0, 0, 0],
               [0, 0, 0, 0, 0, 0]],
    
    "values" : [[0, 0, 0, 0, 0, 0],
               [0, 0, 0, 0, 0, 0],
               [0, 3, 8, 4, 2, 0],
               [0, 4, 8, 2, 3, 0],
               [0, 6, 5, 8, 3, 0],
               [0, 7, 3, 2, 5, 0],
               [0, 0, 0, 0, 0, 0],
               [0, 0, 0, 0, 0, 0]],
    
    "types" : [[0, 0, 0, 0, 0, 0],
               [0, 0, 0, 0, 0, 0],
               [0, 1, 1, 1, 1, 0],
               [0, 1, 2, 1, 1, 0],
               [0, 1, 1, 1, 1, 0],
               [0, 1, 1, 1, 1, 0],
               [0, 0, 0, 0, 0, 0],
               [0, 0, 0, 0, 0, 0]],

    "target" : 46,
    "moves" : 12,
    "gameMode" : 0,
    "idealScore" : 388,
}
